체르투바 : 체르
바실라 : 활무지 
켈소스 : 절망
여왕개미 : 여왕
사반
펠리스 : 비하이브 
템페스트 : 시체
엔쿠라 : 목초지
탈라킨 : 반란군
샤르카 : 체르
판 드라이드 : 구릉지
스탄 : 거인
크루마
티미트리스 : 개간지
오염된 크루마카탄 : 크탑3
카탄 : 크탑6
코어 수스켑터 : 코어
블랙 릴리 : 릴리
메두사
판 나로드 : 판나
마투라 : 약탈자
브래카
베히모스 : 베히
드래곤 비스트 : 드래곤
탈킨
셀루
발보
티미니엘 : 티미
레피로 : 레피
오르펜
바람의 프라임 장로 : 바프장
트롬바
가레스

